*********************
*#########__________*
*___####_____!!!____*
*____##_!!!!!!!!!___*
*_____#__#####______*
*_____#_____________*
*_____#______!###___*
*____________!###___*
*________#_######___*
*_####______________*
*_####_____!!!!!!!!!*
*____________####___*
*____________####___*
*********************
