*********************
*P___#____P____#___P*
*!__!___#___#___!__!*
*#)#))!)!#_#!)!))#)#*
*____#P_______P#____*
*#!_#!_#_#_#_#_!#_!#*
____!#_________#!____
_P!__#!#!___!#!#__!P_
*##!_!_P!___!P_!_!##*
*!_!_#_##___##_#_!_!*
*_P_!#____P____#!_P_*
*_#__!_#!___!#_!__#_*
*___##_________##___*
*********************
