#########__________
___####_____!!!____
____##_____!!!!!___
_____#_____________
_____#_____________
_____#______!###___
____________!###___
____________####___
_####______________
_####____!!!!!!!!!!
____________####___
____________####___
