*********************
*____#_________#____*
*!__!___#___#___!__!*
*#)#))!)!#_#!)!))#)#*
*____#_________#____*
*#!_#!_#_#_#_#_!#_!#*
____!#_________#!____
__!__#!#!___!#!#__!__
*##!_!__!___!__!_!##*
*!_!_#_##___##_#_!_!*
*___!#_________#!___*
*_#__!_#!___!#_!__#_*
*___##_________##___*
*********************
